111111111111
100000000001
1E0000000001
10PC00000001
111111111111