111111111111
100000000P01
1E000000C001
100C00000001
111111111111