1111111
1000001
1E00001
10PC001
1111111
